
VistA/GUI Hybrids (formerly HealtheVet)
Clinical Information Support System (CISS)	Pharmacy: Medication Order Check Healthcare Application (MOCHA) (PREM) - ARCHIVE
Clinical Information Support System (CISS) - ARCHIVE	Pharmacy: Pharmacy Data Update (DATUP) (PRED)
Direct Secure Messaging (WEBD)	Pharmacy: Pharmacy Data Update (DATUP) (PRED) - ARCHIVE
Direct Secure Messaging (WEBD) - ARCHIVE	Pharmacy: Pharmacy Enterprise Customization System (PECS)
Electronic Signature (ESig) (XOBE)	Pharmacy: Pharmacy Enterprise Customization System (PECS) - ARCHIVE
Electronic Signature (ESig) (XOBE) - ARCHIVE	Pharmacy: Pharmacy Product System - National (PPS-N)
HealtheVet Web Services Client (HWSC) (XOBW)	Pharmacy: Pharmacy Product System - National (PPS-N) - ARCHIVE
HealtheVet Web Services Client (HWSC) (XOBW) - ARCHIVE	Registries
Lighthouse (LHS)	Registries - ARCHIVE
Lighthouse (LHS) - ARCHIVE	Spinal Cord Injury and Disorders Outcomes (SCIDO) (SPN)
My HealtheVet (MHV)	Spinal Cord Injury and Disorders Outcomes (SCIDO) (SPN) - ARCHIVE
My HealtheVet (MHV) - ARCHIVE	VA Enrollment System (VES)
National Utilization Management Integration (NUMI)	VA Enrollment System (VES) - ARCHIVE
National Utilization Management Integration (NUMI) - ARCHIVE	Veterans Online Debt Access (VODA)
Occupational Health Record-keeping System (OHRS) - DECOMMISSIONED AUG 2019	Veterans Online Debt Access (VODA) - ARCHIVE
Patient Advocate Tracking System (PATS) (QAC)	Veterans Personal Finance System (VPFS)
Patient Advocate Tracking System (PATS) (QAC) - ARCHIVE	Veterans Personal Finance System (VPFS) - ARCHIVE
Person Services	VHA Point of Service (Kiosks)
Person Services - ARCHIVE	VHA Point of Service (Kiosks) - ARCHIVE
Pharmacy: Medication Order Check Healthcare Application (MOCHA) (PREM)